65535655356553565535655356553565535655356553565535655356553565535655356553565535
65535655356553565535655356553565535655356553565535655356553565535655356553565535
65535655356553200000000000000000000000000000000000000000000000000040956553565535
65535655356553200000000000000000000000000000000000000000000000000040956553565535
65535655356553200000000000000000000000000000000000000000000000000040956553565535
65535655356553200000000000000000000000000000000000000000000000000040956553565535
65535655356553200000000000000000000000000000000000000000000000000040956553565535
65535655356553200000000000000000000000000000000000000000000000000040956553565535
65535655356553200000000000000000000000000000000000000000000000000040956553565535
65535655356553200000000000000000000000000000000000000000000000000040956553565535
65535655356553200000000000000000000000000000000000000000000000000040956553565535
65535655356553200000000000000000000000000000000000000000000000000040956553565535
65535655356553200000000000000000000000000000000000000000000000000040956553565535
65535655356553200000000000000000000000000000000000000000000000000040956553565535
65535655356553200000000000000000000000000000000000000000000000000040956553565535
65535655356553200000000000000000000000000000000000000000000000000040956553565535
65535655356553200000000000000000000000000000000000000000000000000040956553565535
65535655356553200000000000000000000000000000000000000000000000000040956553565535
65535655356553200000000000000000000000000000000000000000000000000040956553565535
65535655356553200000000000000000000000000000000000000000000000000040956553565535
65535655356553200000000000000000000000000000000000000000000000000040956553565535
65535655356553200000000000000000000000000000000000000000000000000040956553565535
65535655356553200000000000000000000000000000000000000000000000000040956553565535
65535655356553200000000000000000000000000000000000000000000000000040956553565535
65535655356553200000000000000000000000000000000000000000000000000040956553565535
65535655356553200000000000000000000000000000000000000000000000000040956553565535
65535655356553200000000000000000000000000000000000000000000000000040956553565535
65535655356553200000000000000000000000000000000000000000000000000040956553565535
65535655356553200000000000000000000000000000000000000000000000000040956553565535
65535655356553200000000000000000000000000000000000000000000000000040956553565535
65535655356553200000000000000000000000000000000000000000000000000040956553565535
65535655356553200000000000000000000000000000000000000000000000000040956553565535
65535655356553200000000000000000000000000000000000000000000000000040956553565535
65535655356553200000000000000000000000000000000000000000000000000040956553565535
65535655356553200000000000000000000000000000000000000000000000000040956553565535
65535655356553200000000000000000000000000000000000000000000000000040956553565535
65535655356553200000000000000000000000000000000000000000000000000040956553565535
65535655356553200000000000000000000000000000000000000000000000000040956553565535
65535655356553200000000000000000000000000000000000000000000000000040956553565535
65535655356553200000000000000000000000000000000000000000000000000040956553565535
65535655356553200000000000000000000000000000000000000000000000000040956553565535
65535655356553200000000000000000000000000000000000000000000000000040956553565535
65535655356553200000000000000000000000000000000000000000000000000040956553565535
65535655356553200000000000000000000000000000000000000000000000000040956553565535
65535655356553200000000000000000000000000000000000000000000000000040956553565535
65535655356553200000000000000000000000000000000000000000000000000040956553565535
65535655356553200000000000000000000000000000000000000000000000000040956553565535
65535655356553200000000000000000000000000000000000000000000000000040956553565535
65535655356553200000000000000000000000000000000000000000000000000040956553565535
65535655356553200000000000000000000000000000000000000000000000000040956553565535
65535655356553200000000000000000000000000000000000000000000000000040956553565535
65535655356553200000000000000000000000000000000000000000000000000040956553565535
65535655356553200000000000000000000000000000000000000000000000000040956553565535
65535655356553200000000000000000000000000000000000000000000000000040956553565535
65535655356553200000000000000000000000000000000000000000000000000040956553565535
65535655356553200000000000000000000000000000000000000000000000000040956553565535
65535655356553200000000000000000000000000000000000000000000000000040956553565535
65535655356553200000000000000000000000000000000000000000000000000040956553565535
65535655356553200000000000000000000000000000000000000000000000000040956553565535
65535655356553200000000000000000000000000000000000000000000000000040956553565535
65535655356553200000000000000000000000000000000000000000000000000040956553565535
65535655356553200000000000000000000000000000000000000000000000000040956553565535
65535655356553200000000000000000000000000000000000000000000000000040956553565535
65535655356553200000000000000000000000000000000000000000000000000040956553565535
65535655356553200000000000000000000000000000000000000000000000000040956553565535
65535655356553200000000000000000000000000000000000000000000000000040956553565535
65535655356553200000000000000000000000000000000000000000000000000040956553565535
65535655356553200000000000000000000000000000000000000000000000000040956553565535
65535655356553200000000000000000000000000000000000000000000000000040956553565535
65535655356553200000000000000000000000000000000000000000000000000040956553565535
65535655356553200000000000000000000000000000000000000000000000000040956553565535
65535655356553200000000000000000000000000000000000000000000000000040956553565535
65535655356553200000000000000000000000000000000000000000000000000040956553565535
65535655356553200000000000000000000000000000000000000000000000000040956553565535
65535655356553200000000000000000000000000000000000000000000000000040956553565535
65535655356553200000000000000000000000000000000000000000000000000040956553565535
65535655356553200000000000000000000000000000000000000000000000000040956553565535
65535655356553200000000000000000000000000000000000000000000000000040956553565535
65535655356553200000000000000000000000000000000000000000000000000040956553565535
65535655356553200000000000000000000000000000000000000000000000000040956553565535
65535655356553200000000000000000000000000000000000000000000000000040956553565535
65535655356553200000000000000000000000000000000000000000000000000040956553565535
65535655356553200000000000000000000000000000000000000000000000000040956553565535
65535655356553200000000000000000000000000000000000000000000000000040956553565535
65535655356553200000000000000000000000000000000000000000000000000040956553565535
65535655356553200000000000000000000000000000000000000000000000000040956553565535
65535655356553200000000000000000000000000000000000000000000000000040956553565535
65535655356553200000000000000000000000000000000000000000000000000040956553565535
65535655356553200000000000000000000000000000000000000000000000000040956553565535
65535655356553200000000000000000000000000000000000000000000000000040956553565535
65535655356553200000000000000000000000000000000000000000000000000040956553565535
65535655356553200000000000000000000000000000000000000000000000000040956553565535
65535655356553200000000000000000000000000000000000000000000000000040956553565535
65535655356553200000000000000000000000000000000000000000000000000040956553565535
65535655356553200000000000000000000000000000000000000000000000000040956553565535
65535655356553200000000000000000000000000000000000000000000000000040956553565535
65535655356553200000000000000000000000000000000000000000000000000040956553565535
65535655356553200000000000000000000000000000000000000000000000000040956553565535
65535655356553200000000000000000000000000000000000000000000000000040956553565535
65535655356553200000000000000000000000000000000000000000000000000040956553565535
65535655356553200000000000000000000000000000000000000000000000000040956553565535
65535655356553200000000000000000000000000000000000000000000000000040956553565535
65535655356553200000000000000000000000000000000000000000000000000040956553565535
65535655356553200000000000000000000000000000000000000000000000000040956553565535
65535655356553200000000000000000000000000000000000000000000000000040956553565535
65535655356553200000000000000000000000000000000000000000000000000040956553565535
65535655356553200000000000000000000000000000000000000000000000000040956553565535
65535655356553200000000000000000000000000000000000000000000000000040956553565535
65535655356553200000000000000000000000000000000000000000000000000040956553565535
65535655356553200000000000000000000000000000000000000000000000000040956553565535
65535655356553200000000000000000000000000000000000000000000000000040956553565535
65535655356553200000000000000000000000000000000000000000000000000040956553565535
65535655356553200000000000000000000000000000000000000000000000000040956553565535
65535655356553200000000000000000000000000000000000000000000000000040956553565535
65535655356553200000000000000000000000000000000000000000000000000040956553565535
65535655356553200000000000000000000000000000000000000000000000000040956553565535
65535655356553200000000000000000000000000000000000000000000000000040956553565535
65535655356553200000000000000000000000000000000000000000000000000040956553565535
65535655356553200000000000000000000000000000000000000000000000000040956553565535
65535655356553200000000000000000000000000000000000000000000000000040956553565535
65535655356553200000000000000000000000000000000000000000000000000040956553565535
65535655356553200000000000000000000000000000000000000000000000000040956553565535
65535655356553200000000000000000000000000000000000000000000000000040956553565535
65535655356553200000000000000000000000000000000000000000000000000040956553565535
65535655356553200000000000000000000000000000000000000000000000000040956553565535
65535655356553200000000000000000000000000000000000000000000000000040956553565535
65535655356553200000000000000000000000000000000000000000000000000040956553565535
65535655356553200000000000000000000000000000000000000000000000000040956553565535
65535655356553200000000000000000000000000000000000000000000000000040956553565535
65535655356553200000000000000000000000000000000000000000000000000040956553565535
65535655356553200000000000000000000000000000000000000000000000000040956553565535
65535655356553200000000000000000000000000000000000000000000000000040956553565535
65535655356553200000000000000000000000000000000000000000000000000040956553565535
65535655356553200000000000000000000000000000000000000000000000000040956553565535
65535655356553200000000000000000000000000000000000000000000000000040956553565535
65535655356553200000000000000000000000000000000000000000000000000040956553565535
65535655356553200000000000000000000000000000000000000000000000000040956553565535
65535655356553200000000000000000000000000000000000000000000000000040956553565535
65535655356553200000000000000000000000000000000000000000000000000040956553565535
65535655356553200000000000000000000000000000000000000000000000000040956553565535
65535655356553200000000000000000000000000000000000000000000000000040956553565535
65535655356553200000000000000000000000000000000000000000000000000040956553565535
65535655356553200000000000000000000000000000000000000000000000000040956553565535
65535655356553200000000000000000000000000000000000000000000000000040956553565535
65535655356553200000000000000000000000000000000000000000000000000040956553565535
65535655356553200000000000000000000000000000000000000000000000000040956553565535
65535655356553200000000000000000000000000000000000000000000000000040956553565535
65535655356553200000000000000000000000000000000000000000000000000040956553565535
65535655356553200000000000000000000000000000000000000000000000000040956553565535
65535655356553200000000000000000000000000000000000000000000000000040956553565535
65535655356553200000000000000000000000000000000000000000000000000040956553565535
65535655356553200000000000000000000000000000000000000000000000000040956553565535
65535655356553200000000000000000000000000000000000000000000000000040956553565535
65535655356553200000000000000000000000000000000000000000000000000040956553565535
65535655356553200000000000000000000000000000000000000000000000000040956553565535
65535655356553200000000000000000000000000000000000000000000000000040956553565535
65535655356553200000000000000000000000000000000000000000000000000040956553565535
65535655356553200000000000000000000000000000000000000000000000000040956553565535
65535655356553200000000000000000000000000000000000000000000000000040956553565535
65535655356553200000000000000000000000000000000000000000000000000040956553565535
65535655356553200000000000000000000000000000000000000000000000000040956553565535
65535655356553200000000000000000000000000000000000000000000000000040956553565535
65535655356553200000000000000000000000000000000000000000000000000040956553565535
65535655356553200000000000000000000000000000000000000000000000000040956553565535
65535655356553200000000120000000000000480000000000000000000000000040956553565535
65535655356553200000000120000000000000480000000000000000000000000040956553565535
65535655356553200000000120000015360000480000000000000000000000000040956553565535
65535655356553200000000120000165408000480000000000000000000000000040956553565535
65535655356553200000000120000365472000480000000000000000000000000040956553565535
65535655356553200000000120000765504000480000000000000000000000000040956553565535
65535655356553200000000120000765504000480000000000000000000000000040956553565535
65535655356553200000000120000765504000480000000000000000000000000040956553565535
65535655356553200000000120000765504000480000000000000000000000000040956553565535
65535655356553200000000120000765504000480000000000000000000000000040956553565535
65535655356553200000000120000765504000480000000000000000000000000040956553565535
65535655356553200000000120000765504000480000000000000000000000000040956553565535
65535655356553200000000120000765504000480000000000000000000000000040956553565535
65535655356553200000000120000000000000480000000000000000000000000040956553565535
65535655356553200000000120000000000000480000000000000000000000000040956553565535
65535655356553200000000156553565535655200000000000000000000000000040956553565535
65535655356553200000000156553565535655200000000000000000000000000040956553565535
65535655356553200000000156553565535655200000000000000000000000000040956553565535
65535655356553200000000156553565535655200000000000000000000000000040956553565535
65535655356553200000000156553565535655200000000000000000000000000040956553565535
65535655356553200000000156553565535655200000000000020476540800000040956553565535
65535655356553200000000156553565535655200000000000020476540800000040956553565535
65535655356553200000000156553565535655200000000000163836552000000040956553565535
65535655356553200000000156553565535655200000000000163836552000000040956553565535
65535655356553200000000156553565535655200000000000163836552000000040956553565535
65535655356553200000000156553565535655200000000000655356553200000040956553565535
65535655356553200000000156553565535655200000000000655356553200000040956553565535
65535655356553200000000156553565535655200000000000655356553200000040956553565535
65535655356553200000000156553565535655200000000001655356553400000040956553565535
65535655356553200000000156553565535655200000000001655356553400000040956553565535
65535655356553200000000156553565535655200000000001655356553400000040956553565535
65535655356553200000000156553565535655200000000001655356553400000040956553565535
65535655356553200000000156553565535655200000000000327676552800000040956553565535
65535655356553200000000156553565535655200000000000327676552800000040956553565535
65535655356553200000000156553565535655200000000000327676552800000040956553565535
65535655356553200000000156553565535655200000000000327676552800000040956553565535
65535655356553200000000156553565535655200000000000327676552800000040956553565535
65535655356553200000000156553565535655200000000000327676552800000040956553565535
65535655356553200000000156553565535655200000000000327676552800000040956553565535
65535655356553200000000156553565535655200000000000327676552800000040956553565535
65535655356553200000000156553565535655200000000000327676552800000040956553565535
65535655356553200000000156553565535655200000000000327676552800000040956553565535
65535655356553200000000156553565535655200000000000327676552800000040956553565535
65535655356553200000000156553565535655200000000000327676552800000040956553565535
65535655356553200000000156553565535655200000000000327676552800000040956553565535
65535655356553200000000156553565535655200000000000327676552800000040956553565535
65535655356553200000000156553565535655200000000000327676552800000040956553565535
65535655356553200000000156553565535655200000000000327676552800000040956553565535
65535655356553200000000156553565535655200000000000000000000000000040956553565535
65535655356553200000000156553565535655200000000000000000000000000040956553565535
65535655356553200000000156553565535655200000000000000000000000000040956553565535
65535655356553200000000156553565535655200000000000000000000000000040956553565535
65535655356553200000000156553565535655200000000000000000000000000040956553565535
65535655356553200000000156553565535655200000000000000000000000000040956553565535
65535655356553200000000076553565535655040000000000000000000000000040956553565535
65535655356553200000000000000000000000000000000000000000000000000040956553565535
65535655356553200000000000000000000000000000000000000000000000000040956553565535
65535655356553200000000000000000000000000000000000000000000000000040956553565535
65535655356553200000000000000000000000000000000000000000000000000040956553565535
65535655356553200000000000000000000000000000000000000000000000000040956553565535
65535655356553200000000000000000000000000000000000000000000000000040956553565535
65535655356553200000000000000000000000000000000000000000000000000040956553565535
65535655356553200000000000000000000000000000000000000000000000000040956553565535
65535655356553200000000000000000000000000000000000000000000000000040956553565535
65535655356553200000000000000000000000000000000000000000000000000040956553565535
65535655356553200000000000000000000000000000000000000000000000000040956553565535
65535655356553200000000000000000000000000000000000000000000000000040956553565535
65535655356553200000000000000000000000000000000000000000000000000040956553565535
65535655356553200000000000000000000000000000000000000000000000000040956553565535
65535655356553200000000000000000000000000000000000000000000000000040956553565535
65535655356553200000000000000000000000000000000000000000000000000040956553565535
65535655356553200000000000000000000000000000000000000000000000000040956553565535
65535655356553200000000000000000000000000000000000000000000000000040956553565535
65535655356553200000000000000000000000000000000000000000000000000040956553565535
65535655356553200000000000000000000000000000000000000000000000000040956553565535
65535655356553200000000000000000000000000000000000000000000000000040956553565535
65535655356553200000000000000000000000000000000000000000000000000040956553565535
65535655356553200000000000000000000000000000000000000000000000000040956553565535
65535655356553200000000000000000000000000000000000000000000000000040956553565535
65535655356553200000000000000000000000000000000000000000000000000040956553565535
65535655356553200000000000000000000000000000000000000000000000000040956553565535
65535655356553200000000000000000000000000000000000000000000000000040956553565535
65535655356553200000000000000000000000000000000000000000000000000040956553565535
65535655356553200000000000000000000000000000000000000000000000000040956553565535
65535655356553200000000000000000000000000000000000000000000000000040956553565535
65535655356553200000000000000000000000000000000000000000000000000040956553565535
65535655356553200000000000000000000000000000000000000000000000000040956553565535
65535655356553200000000000000000000000000000000000000000000000000040956553565535
65535655356553200000000000000000000000000000000000000000000000000040956553565535
65535655356553200000000000000000000000000000000000000000000000000040956553565535
65535655356553565535655356553565535655356553565535655356553565535655356553565535
65535655356553565535655356553565535655356553565535655356553565535655356553565535