65535655356553565535655356553565535655356553565535655356553565535655356553565535
65535655356553565535655356553565535655356553565535655356553565535655356553565535
65535655356553565535655356553565535655356553565535655356553565535655356553565535
65535655356553565535655356553565535655356553565535655356553565535655356553565535
65535655356553565535655356553565535655356553565535655356553565535655356553565535
65535655356553565535655356553565535655356553565535655356553565535655356553565535
65535655356553565535655356553565535655356553565535655356553565535655356553565535
65535655356553565535655356553565535655356553565535655356553565535655356553565535
65535655356553565535655356553565535655356553565535655356553565535655356553565535
65535655356553565535655356553565535655356553565535655356553565535655356553565535
65535650240000000000000000012765535655356553565535650240000000000000000012765535
65535573440000000000000000000765535655356553565535573440000000000000000000765535
65535327680000000000000000000165535655356553565535327680000000000000000000165535
65534000000000000000000000000032767655356553565534000000000000000000000000032767
65532000000000000000000000000016383655356553565532000000000000000000000000016383
65528000000000000000000000000008191655356553565528000000000000000000000000008191
65528000000000000000000000000008191655356553565528000000000000000000000000008191
65520000000000000000000000000004095655356553565520000000000000000000000000004095
65504000000000000000000000000002047655356553565504000000000000000000000000002047
65504000000000000000000000000002047655356553565504000000000000000000000000002047
65504000000000000000000000000002047655356553565504000000000000000000000000002047
65504000000000000000000000000002047655356553565504000000000000000000000000002047
65504000000000000000000000000002047655356553565504000000000000000000000000002047
65472000000000000000000000000001023655356553565472000000000000000000000000001023
65472000000000000000000000000001023655356553565472000000000000000000000000001023
65472000000000000000000000000001023655356553565472000000000000000000000000001023
65472000000000000000000000000001023655356553565472000000000000000000000000001023
65472000000000000000000000000001023655356553565472000000000000000000000000001023
65472000000000000000000000000001023655356553565472000000000000000000000000001023
65472000000000000000000000000001023655356553565472000000000000000000000000001023
65472000000000000000000000000001023655356553565472000000000000000000000000001023
65472000000000000000000000000001023655356553565472000000000000000000000000001023
65472000000000000000000000000001023655356553565472000000000000000000000000001023
65472000000000000000000000000001023655356553565472000000000000000000000000001023
65472000000000000000000000000001023655356553565472000000000000000000000000001023
65472000000000000000000000000001023655356553565472000000000000000000000000001023
65472000000000000000000000000001023655356553565472000000000000000000000000001023
65472000000000000000000000000001023655356553565472000000000000000000000000001023
65472000000000000000000000000001023655356553565472000000000000000000000000001023
65472000000000000000000000000001023655356553565472000000000000000000000000001023
65472000000000000000000000000001023655356553565472000000000000000000000000001023
65472000000000000000000000000001023655356553565472000000000000000000000000001023
65472000000000000000000000000001023655356553565472000000000000000000000000001023
65472000000000000000000000000001023655356553565472000000000000000000000000001023
65472000000000000000000000000001023655356553565472000000000000000000000000001023
65472000000000000000000000000001023655356553565472000000000000000000000000001023
65472000000000000000000000000001023655356553565472000000000000000000000000001023
65472000000000000000000000000001023655356553565472000000000000000000000000001023
65472000000000000000000000000001023655356553565472000000000000000000000000001023
65472000000000000000000000000001023655356553565472000000000000000000000000001023
65472000000000000000000000000001023655356553565472000000000000000000000000001023
65472000000000000000000000000001023655356553565472000000000000000000000000001023
65472000000000000000000000000001023655356553565472000000000000000000000000001023
65472000000000000000000000000001023655356553565472000000000000000000000000001023
65472000000000000000000000000001023655356553565472000000000000000000000000001023
65472000000000000000000000000001023655356553565472000000000000000000000000001023
65472000000000000000000000000001023655356553565472000000000000000000000000001023
65472000000000000000000000000001023655356553565472000000000000000000000000001023
65472000000000000000000000000001023655356553565472000000000000000000000000001023
65472000000000000000000000000001023655356553565472000000000000000000000000001023
65472000000000000000000000000001023655356553565472000000000000000000000000001023
65472000000000000000000000000001023655356553565472000000000000000000000000001023
65472000000000000000000000000001023655356553565472000000000000000000000000001023
65472000000000000000000000000001023655356553565472000000000000000000000000001023
65472000000000000000000000000001023655356553565472000000000000000000000000001023
65472000000000000000000000000001023655356553565472000000000000000000000000001023
65472000000000000000000000000001023655356553565472000000000000000000000000001023
65472000000000000000000000000001023655356553565472000000000000000000000000001023
65472000000000000000000000000001023655356553565472000000000000000000000000001023
65472000000000000000000000000001023655356553565472000000000000000000000000001023
65472000000000000000000000000001023655356553565472000000000000000000000000001023
65472000000000000000000000000001023655356553565472000000000000000000000000001023
65472000000000000000000000000001023655356553565472000000000000000000000000001023
65472000000000000000000000000001023655356553565472000000000000000000000000001023
65472000000000000000000000000001023655356553565472000000000000000000000000001023
65472000000000000000000000000001023655356553565472000000000000000000000000001023
65472000000000000000000000000001023655356553565472000000000000000000000000001023
65472000000000000000000000000001023655356553565472000000000000000000000000001023
65472000000000000000000000000001023655356553565472000000000000000000000000001023
65472000000000000000000000000001023655356553565472000000000000000000000000001023
65472000000000000000000000000001023655356553565472000000000000000000000000001023
65472000000000000000000000000001023655356553565472000000000000000000000000001023
65472000000000000000000000000001023655356553565472000000000000000000000000001023
65472000000000000000000000000001023655356553565472000000000000000000000000001023
65472000000000000000000000000001023655356553565472000000000000000000000000001023
65472000000000000000000000000001023655356553565472000000000000000000000000001023
65472000000000000000000000000001023655356553565472000000000000000000000000001023
65472000000000000000000000000001023655356553565472000000000000000000000000001023
65472000000000000000000000000001023655356553565472000000000000000000000000001023
65504000000000000000000000000002047655356553565504000000000000000000000000002047
65504000000000000000000000000002047655356553565504000000000000000000000000002047
65504000000000000000000000000002047655356553565504000000000000000000000000002047
65504000000000000000000000000002047655356553565504000000000000000000000000002047
65504000000000000000000000000002047655356553565504000000000000000000000000002047
65520000000000000000000000000004095655356553565520000000000000000000000000004095
65528000000000000000000000000008191655356553565528000000000000000000000000008191
65528000000000000000000000000008191655356553565528000000000000000000000000008191
65532000000000000000000000000016383655356553565532000000000000000000000000016383
65534000000000000000000000000032767655356553565534000000000000000000000000032767
65535327680000000000000000000165535655356553565535327680000000000000000000165535
65535573440000000000000000000765535655356553565535573440000000000000000000765535
65535650240000000000000000012765535655356553565535650240000000000000000012765535
65535655356502400000001276553565535655356553565535655356502400000001276553565535
65535655356528000000002556553565535655356553565535655356528000000002556553565535
65535655356528000000002556553565535655356553565535655356528000000002556553565535
65535655356528000000002556553565535655356553565535655356528000000002556553565535
65535655356528000000002556553565535655356553565535655356528000000002556553565535
65535655356528000000002556553565535655356553565535655356528000000002556553565535
65535655356528000000002556553565535655356553565535655356528000000002556553565535
65535655356528000000002556553565535655356553565535655356528000000002556553565535
65535655356528000000002556553565535655356553565535655356528000000002556553565535
65535655356528000000002556553565535655356553565535655356528000000002556553565535
65535655356528000000002556553565535655356553565535655356528000000002556553565535
65535655356528000000002556553565535655356553565535655356528000000002556553565535
65535655356528000000002556553565535655356553565535655356528000000002556553565535
65535655356528000000002556553565535655356553565535655356528000000002556553565535
65535655356528000000002556553565535655356553565535655356528000000002556553565535
65535655356528000000002556553565535655356553565535655356528000000002556553565535
65535655356528000000002556553565535655356553565535655356528000000002556553565535
65535655356528000000002556553565535655356553565535655356528000000002556553565535
65535655356528000000002556553565535655356553565535655356528000000002556553565535
65535655356528000000002556553565535655356553565535655356528000000002556553565535
65535655356528000000002556553565535655356553565535655356528000000002556553565535
65535655356528000000002556553565535655356553565535655356528000000002556553565535
65535655356528000000002556553565535655356553565535655356528000000002556553565535
65535655356528000000002556553565535655356553565535655356528000000002556553565535
65535655356528000000002556553565535655356553565535655356528000000002556553565535
65535655356528000000002556553565535655356553565535655356528000000002556553565535
65535655356528000000002556553565535655356553565535655356528000000002556553565535
65535655356528000000002556553565535655356553565535655356528000000002556553565535
65535655356528000000002556553565535655356553565535655356528000000002556553565535
65535655356528000000002556553565535655356553565535655356528000000002556553565535
65535655356528000000002556553565535655356553565535655356528000000002556553565535
65535655356528000000002556553565535655356553565535655356528000000002556553565535
65535655356528000000002556553565535655356553565535655356528000000002556553565535
65535655356528000000002556553565535655356553565535655356528000000002556553565535
65535655356528000000002556553565535655356553565535655356528000000002556553565535
65535655356528000000002556553565535655356553565535655356528000000002556553565535
65535655356528000000002556553565535655356553565535655356528000000002556553565535
65535655356528000000002556553565535655356553565535655356528000000002556553565535
65535655356528000000002556553565535655356553565535655356528000000002556553565535
65535655356528000000002556553565535655356553565535655356528000000002556553565535
65535655356528000000002556553565535655356553565535655356528000000002556553565535
65535655356528000000002556553565535655356553565535655356528000000002556553565535
65535655356528000000002556553565535655356553565535655356528000000002556553565535
65535655356528000000002556553565535655356553565535655356528000000002556553565535
65535655356528000000002556553565535655356553565535655356528000000002556553565535
65535655356528000000002556553565535655356553565535655356528000000002556553565535
65535655356528000000002556553565535655356553565535655356528000000002556553565535
65535655356528000000002556553565535655356553565535655356528000000002556553565535
65535655356528000000002556553565535655356553565535655356528000000002556553565535
65535655356528000000002556553565535655356553565535655356528000000002556553565535
65535655356528000000002556553565535655356553565535655356528000000002556553565535
65535655356502400000001276553565535655356553565535655356502400000001276553565535
65535650240000000000000000012765535655356553565535650240000000000000000012765535
65535573440000000000000000000765535655356553565535573440000000000000000000765535
65535327680000000000000000000165535655356553565535327680000000000000000000165535
65534000000000000000000000000032767655356553565534000000000000000000000000032767
65532000000000000000000000000016383655356553565532000000000000000000000000016383
65528000000000000000000000000008191655356553565528000000000000000000000000008191
65528000000000000000000000000008191655356553565528000000000000000000000000008191
65520000000000000000000000000004095655356553565520000000000000000000000000004095
65504000000000000000000000000002047655356553565504000000000000000000000000002047
65504000000000000000000000000002047655356553565504000000000000000000000000002047
65504000000000000000000000000002047655356553565504000000000000000000000000002047
65504000000000000000000000000002047655356553565504000000000000000000000000002047
65504000000000000000000000000002047655356553565504000000000000000000000000002047
65472000000000000000000000000001023655356553565472000000000000000000000000001023
65472000000000000000000000000001023655356553565472000000000000000000000000001023
65472000000000000000000000000001023655356553565472000000000000000000000000001023
65472000000000000000000000000001023655356553565472000000000000000000000000001023
65472000000000000000000000000001023655356553565472000000000000000000000000001023
65472000000000000000000000000001023655356553565472000000000000000000000000001023
65472000000000000000000000000001023655356553565472000000000000000000000000001023
65472000000000000000000000000001023655356553565472000000000000000000000000001023
65472000000000000000000000000001023655356553565472000000000000000000000000001023
65472000000000000000000000000001023655356553565472000000000000000000000000001023
65472000000000000000000000000001023655356553565472000000000000000000000000001023
65472000000000000000000000000001023655356553565472000000000000000000000000001023
65472000000000000000000000000001023655356553565472000000000000000000000000001023
65472000000000000000000000000001023655356553565472000000000000000000000000001023
65472000000000000000000000000001023655356553565472000000000000000000000000001023
65472000000000000000000000000001023655356553565472000000000000000000000000001023
65472000000000000000000000000000511655356553565408000000000000000000000000001023
65472000000000000000000000000000000000000000000000000000000000000000000000001023
65472000000000000000000000000000000000000000000000000000000000000000000000001023
65472000000000000000000000000000000000000000000000000000000000000000000000001023
65472000000000000000000000000000000000000000000000000000000000000000000000001023
65472000000000000000000000000000000000000000000000000000000000000000000000001023
65472000000000000000000000000000000000000000000000000000000000000000000000001023
65472000000000000000000000000000000000000000000000000000000000000000000000001023
65472000000000000000000000000000000000000000000000000000000000000000000000001023
65472000000000000000000000000000000000000000000000000000000000000000000000001023
65472000000000000000000000000000000000000000000000000000000000000000000000001023
65472000000000000000000000000000000000000000000000000000000000000000000000001023
65472000000000000000000000000000000000000000000000000000000000000000000000001023
65472000000000000000000000000000000000000000000000000000000000000000000000001023
65472000000000000000000000000000000000000000000000000000000000000000000000001023
65472000000000000000000000000000000000000000000000000000000000000000000000001023
65472000000000000000000000000000000000000000000000000000000000000000000000001023
65472000000000000000000000000000000000000000000000000000000000000000000000001023
65472000000000000000000000000000000000000000000000000000000000000000000000001023
65472000000000000000000000000000000000000000000000000000000000000000000000001023
65472000000000000000000000000000000000000000000000000000000000000000000000001023
65472000000000000000000000000000000000000000000000000000000000000000000000001023
65472000000000000000000000000000000000000000000000000000000000000000000000001023
65472000000000000000000000000000000000000000000000000000000000000000000000001023
65472000000000000000000000000000000000000000000000000000000000000000000000001023
65472000000000000000000000000000000000000000000000000000000000000000000000001023
65472000000000000000000000000000000000000000000000000000000000000000000000001023
65472000000000000000000000000000000000000000000000000000000000000000000000001023
65472000000000000000000000000000000000000000000000000000000000000000000000001023
65472000000000000000000000000000000000000000000000000000000000000000000000001023
65472000000000000000000000000000000000000000000000000000000000000000000000001023
65472000000000000000000000000000000000000000000000000000000000000000000000001023
65472000000000000000000000000000000000000000000000000000000000000000000000001023
65472000000000000000000000000000511655356553565408000000000000000000000000001023
65472000000000000000000000000001023655356553565472000000000000000000000000001023
65472000000000000000000000000001023655356553565472000000000000000000000000001023
65472000000000000000000000000001023655356553565472000000000000000000000000001023
65472000000000000000000000000001023655356553565472000000000000000000000000001023
65472000000000000000000000000001023655356553565472000000000000000000000000001023
65472000000000000000000000000001023655356553565472000000000000000000000000001023
65472000000000000000000000000001023655356553565472000000000000000000000000001023
65472000000000000000000000000001023655356553565472000000000000000000000000001023
65472000000000000000000000000001023655356553565472000000000000000000000000001023
65472000000000000000000000000001023655356553565472000000000000000000000000001023
65472000000000000000000000000001023655356553565472000000000000000000000000001023
65472000000000000000000000000001023655356553565472000000000000000000000000001023
65472000000000000000000000000001023655356553565472000000000000000000000000001023
65472000000000000000000000000001023655356553565472000000000000000000000000001023
65472000000000000000000000000001023655356553565472000000000000000000000000001023
65472000000000000000000000000001023655356553565472000000000000000000000000001023
65504000000000000000000000000002047655356553565504000000000000000000000000002047
65504000000000000000000000000002047655356553565504000000000000000000000000002047
65504000000000000000000000000002047655356553565504000000000000000000000000002047
65504000000000000000000000000002047655356553565504000000000000000000000000002047
65504000000000000000000000000002047655356553565504000000000000000000000000002047
65520000000000000000000000000004095655356553565520000000000000000000000000004095
65528000000000000000000000000008191655356553565528000000000000000000000000008191
65528000000000000000000000000008191655356553565528000000000000000000000000008191
65532000000000000000000000000016383655356553565532000000000000000000000000016383
65534000000000000000000000000032767655356553565534000000000000000000000000032767
65535327680000000000000000000165535655356553565535327680000000000000000000165535
65535573440000000000000000000765535655356553565535573440000000000000000000765535
65535650240000000000000000012765535655356553565535650240000000000000000012765535
65535655356553565535655356553565535655356553565535655356553565535655356553565535
65535655356553565535655356553565535655356553565535655356553565535655356553565535
65535655356553565535655356553565535655356553565535655356553565535655356553565535
65535655356553565535655356553565535655356553565535655356553565535655356553565535
65535655356553565535655356553565535655356553565535655356553565535655356553565535
65535655356553565535655356553565535655356553565535655356553565535655356553565535
65535655356553565535655356553565535655356553565535655356553565535655356553565535
65535655356553565535655356553565535655356553565535655356553565535655356553565535
65535655356553565535655356553565535655356553565535655356553565535655356553565535
65535655356553565535655356553565535655356553565535655356553565535655356553565535